#############################################################
#H                                                          #
#                                                           #
#                                                           #
#                                                           #
#                                                           #
#                                                           #
#                                                           #
#                                                           #
#                                                           #
#                                                           #
#                                                           #
#                                                           #
#                                                           #
#                                                           #
#                                                           #
#                                                           #
#                                                           #
#                                                           #
#                                                           #
#                                                           #
#                                                           #
#                                                           #
#                                                           #
#                                                           #
#                                                           #
#                                                           #
#                                                           #
#                                                           #
#                                                           #
#                                                           #
#                                                           #
#                                                           #
#                                                          E#
#############################################################